1111111111111111111
1E00000000000000001
1000000010000000001
10000001C1000000001
1000000010000000001
1000000000000C00001
100000000000000P001
1000000000000000001
1000000000000000001
1111111111111111111
