1111111111111111111
100000000000000E0E1
1000000000000000001
1000000000000000001
10000000000000000C1
1000P00000000000001
1000000000000000001
1111111111111111111
