11111111111111111
10000000000000001
1000000E000000001
11111000001111001
100000P0000000001
11111111111111111
