111111 111
10000C00E1
1000000001
1000P00001
1000000001
1000000001
1000000001
1111111111
