11111111111111111111
10000000000000000001
1P000000000000000001
10000000000111100001
11111111111111111111
