11111111111111111111
100001000000000000E1
1P00010C00000C000001
10000000011100011101
11111111110000000001
1000000000000C000001
11111111111111111111
