1111111111111111111
1C000000000000000E1
1111111111000111111
1001110000000000001
1000000001111000001
1000100100101010101
1P00000000000000001
100000001100000C111
111100011111C1C1111
1111111111111111111
