11111111111111111111
100000000000000000E1
1P00000C00000C000001
10000000011100011101
10000000000000000001
10000000000000000001
11111111111111111111
