111111111111
100000000001
1OOOOOOOOOO1
100000000001
1P0000000CE1
111111111111
